
NO images/blue_wall.xpm
SO images/red_brick.xpm
WE images/brown_wall.xpm
EA images/grey_wall.xpm

F 220,100,0
C 225,30,0

11111111111111111111111111111111111111111111111111111111111111111111111111111111
10000000000000000000000000000000000000000000000000000000000000000000000000000001
10001000100010001001000100010001000100010001000100010001000100010001000100010001
10001000100010001001000100010001000100010001000100010001000100010001000100010001
10001000100010001001000100010001000100010001000100010001000100010001000100010001
10000000000000000000000000000000000000000000000000000000000000000000000000000001
10001000100010001001000100010001000100010001000100010001000100010001000100010001
10001000100010001001000100010001000100010001000100010001000100010001000100010001
10001000100010001001000100010001000100010001000100010001000100010001000100010001
10000000000000000000000000000000000000000000000000000000000000000000000000000001
10001000100010001001000100010001000100010001000100010001000100010001000100010001
10001000100010001001000100010001000100010001000100010001000100010001000100010001
10001000100010001001000100010001000100010001000100010001000100010001000100010001
10000000000000000000000000000000000000000000000000000000000000000000000000000001
10001000100010001001000100010001000100010001000100010001000100010001000100010001
10001000100010001001000100010001000100010001000100010001000100010001000100010001
10001000100010001001000100010001000100010001000100010001000100010001000100010001
10000000000000000000000000000000000000000000000000000000000000000000000000000001
10001000100010001001000100010001000100010001000100010001000100010001000100010001
10001000100010001001000100010001000100010001000100010001000100010001000100010001
10001000100010001001000100010001000100010001000100010001000100010001000100010001
10000000000000000000000000000000S00000000000000000000000000000000000000000000001
10001000100010001001000100010001000100010001000100010001000100010001000100010001
10001000100010001001000100010001000100010001000100010001000100010001000100010001
10001000100010001001000100010001000100010001000100010001000100010001000100010001
10000000000000000000000000000000000000000000000000000000000000000000000000000001
10001000100010001001000100010001000100010001000100010001000100010001000100010001
10001000100010001001000100010001000100010001000100010001000100010001000100010001
10001000100010001001000100010001000100010001000100010001000100010001000100010001
10000000000000000000000000000000000000000000000000000000000000000000000000000001
10001000100010001001000100010001000100010001000100010001000100010001000100010001
10001000100010001001000100010001000100010001000100010001000100010001000100010001
10001000100010001001000100010001000100010001000100010001000100010001000100010001
10000000000000000000000000000000000000000000000000000000000000000000000000000001
10001000100010001001000100010001000100010001000100010001000100010001000100010001
10001000100010001001000100010001000100010001000100010001000100010001000100010001
10001000100010001001000100010001000100010001000100010001000100010001000100010001
10000000000000000000000000000000000000000000000000000000000000000000000000000001
10001000100010001001000100010001000100010001000100010001000100010001000100010001
10001000100010001001000100010001000100010001000100010001000100010001000100010001
10001000100010001001000100010001000100010001000100010001000100010001000100010001
10000000000000000000000000000000000000000000000000000000000000000000000000000001
10001000100010001001000100010001000100010001000100010001000100010001000100010001
10001000100010001001000100010001000100010001000100010001000100010001000100010001
10001000100010001001000100010001000100010001000100010001000100010001000100010001
10000000000000000000000000000000000000000000000000000000000000000000000000000001
10001000100010001001000100010001000100010001000100010001000100010001000100010001
10001000100010001001000100010001000100010001000100010001000100010001000100010001
10001000100010001001000100010001000100010001000100010001000100010001000100010001
10000000000000000000000000000000000000000000000000000000000000000000000000000001
11111111111111111111111111111111111111111111111111111111111111111111111111111111
