NO images/bluestone.xpm
SO images/mossy.xpm
WE images/purplestone.xpm
EA images/eagle.xpm

F 18,53,77
C 153,204,255

11111111111111111111111111111111111111111111111111111111111111111111111111111111
10000000000000000000000000000000000000000000000000000000000000000000000000000001
10001000100010001001000100010001000100010001000100010001000100010001000100010001
10001000100010001001000100010001000100010001000100010001000100010001000100010001
10001000100010001001000100010001000100010001000100010001000100010001000100010001
10000000000000000000000000000000000000000000000000000000000000000000000000000001
10001000100010001001000100010001000100010001000100010001000100010001000100010001
10001000100010001001000100010001000100010001000100010001000100010001000100010001
10001000100010001001000100010001000100010001000100010001000100010001000100010001
10000000000000000000000000000000000000000000000000000000000000000000000000000001
10001000100010001001000100010001000100010001000100010001000100010001000100010001
10001000100010001001000100010001000100010001000100010001000100010001000100010001
10001000100010001001000100010001000100010001000100010001000100010001000100010001
10000000000000000000000000000000000000000000000000000000000000000000000000000001
10001000100010001001000100010001000100010001000100010001000100010001000100010001
10001000100010001001000100010001000100010001000100010001000100010001000100010001
10001000100010001001000100010001000100010001000100010001000100010001000100010001
10000000000000000000000000000000000000000000000000000000000000000000000000000001
10001000100010001001000100010001000100010001000100010001000100010001000100010001
10001000100010001001000100010001000100010001000100010001000100010001000100010001
10001000100010001001000100010001000100010001000100010001000100010001000100010001
10000000000000000000000000000000S00000000000000000000000000000000000000000000001
10001000100010001001000100010001000100010001000100010001000100010001000100010001
10001000100010001001000100010001000100010001000100010001000100010001000100010001
10001000100010001001000100010001000100010001000100010001000100010001000100010001
10000000000000000000000000000000000000000000000000000000000000000000000000000001
10001000100010001001000100010001000100010001000100010001000100010001000100010001
10001000100010001001000100010001000100010001000100010001000100010001000100010001
10001000100010001001000100010001000100010001000100010001000100010001000100010001
10000000000000000000000000000000000000000000000000000000000000000000000000000001
10001000100010001001000100010001000100010001000100010001000100010001000100010001
10001000100010001001000100010001000100010001000100010001000100010001000100010001
10001000100010001001000100010001000100010001000100010001000100010001000100010001
10000000000000000000000000000000000000000000000000000000000000000000000000000001
10001000100010001001000100010001000100010001000100010001000100010001000100010001
10001000100010001001000100010001000100010001000100010001000100010001000100010001
10001000100010001001000100010001000100010001000100010001000100010001000100010001
10000000000000000000000000000000000000000000000000000000000000000000000000000001
10001000100010001001000100010001000100010001000100010001000100010001000100010001
10001000100010001001000100010001000100010001000100010001000100010001000100010001
10001000100010001001000100010001000100010001000100010001000100010001000100010001
10000000000000000000000000000000000000000000000000000000000000000000000000000001
10001000100010001001000100010001000100010001000100010001000100010001000100010001
10001000100010001001000100010001000100010001000100010001000100010001000100010001
10001000100010001001000100010001000100010001000100010001000100010001000100010001
10000000000000000000000000000000000000000000000000000000000000000000000000000001
10001000100010001001000100010001000100010001000100010001000100010001000100010001
10001000100010001001000100010001000100010001000100010001000100010001000100010001
10001000100010001001000100010001000100010001000100010001000100010001000100010001
10000000000000000000000000000000000000000000000000000000000000000000000000000001
11111111111111111111111111111111111111111111111111111111111111111111111111111111
