NO images/bluestone.xpm
SO images/mossy.xpm
WE images/purplestone.xpm
EA images/eagle.xpm

F 18,53,77
C 153,204,255

1111111111111111111
1000000000000000001
1000000000W00000001
1000000000000000001
1000011000000111001
1000111100000010001
1100011110000000111
1000011111100001001
1000001111110001001
1000000111111001001
1000000111110000001
1000000000000000001
1111111111111111111
