
NO images/blue_wall.xpm
SO images/red_brick.xpm
WE images/brown_wall.xpm
EA images/grey_wall.xpm

F 220,100,0
C 225,30,0

11111
11S11
10001
10001
10001
10101
10101
10101
10101
10101
10101
10101
11111
