
NO images/bluestone.xpm
SO images/mossy.xpm
WE images/purplestone.xpm
EA images/eagle.xpm

F 18,53,77
C 153,204,255

11111
11011
10001
10001
10001
10101
10101
10101
10101
10101
10101
1N101
11111
