NO images/blue_wall.xpm
SO images/red_brick.xpm
WE images/brown_wall.xpm
EA images/grey_wall.xpm

F 220,100,0
C 225,30,0

111111111111
100000000001
100000000N01
100000000001
100001100001
100011110001
110001111001
100001111111
100000111111
100000011111
100000011111
100000000001
111111111111