NO images/wood.xpm
SO images/mossy.xpm
WE images/mossy.xpm
EA images/mossy.xpm

F 220,100,0
C 225,30,0

N111111111111111111
1000000000000000001
1000000000000000001
1000000000000000001
1000011000000111001
1000111100000010001
1100011110000000111
1000011111100001001
1000001111110001001
1000000111111001001
1000000111110000001
1000000000000000001
1111111111111111111