NO images/bluestone.xpm
SO images/mossy.xpm
WE images/redbrick.xpm
EA images/eagle.xpm

F 18,53,25500000
C 153,204,255

111111111111
100000000001
10S000000001
100000000001
100001100001
100011110001
110001111001
100001111111
100000111111
100000011111
100000011111
100000000001
111111111111